1111111111111111111111
1000011001000010000001
1100111010100010000001
1000110101100000000101
1010001001000010000001
1100001000110000001111
1000000100001000000001
1100000001000000001001
1000000000010000000001
1111111111111111111111
